############
#...#......#
#...#...####
#...#......#
#...#..#...#
#......#...#
#..#####...#
#..#.......#
#..#..#.##.#
#..#..#.##.#
#.....#....#
############