############
#..........#
#...###.####
#...#......#
#...#..###.#
#......#.#.#
#...####.#.#
#..#.....#.#
#..#..#..#.#
#.....#....#
#.....#....#
############