####################
#                  #
#  ############### #
#                # #
#                # #
#                # #
#                # #
#                # #
#                # #
############     # #
#                # #
#                # #
#                # #
#                # #
#                # #
#     ############ #
#                # #
#                # #
#                  #
####################